3,2,2,2,2,2,2,2,7,7,7,7,2,2,2,2,2,2,2,4
1,0,0,0,0,0,0,0,1,1,1,1,0,0,0,0,0,0,0,1
1,0,2,2,2,2,2,0,0,1,1,0,0,2,2,2,2,2,0,1
1,0,0,0,0,0,0,0,0,0,0,0,0,0,0,0,0,0,0,1
1,0,0,3,2,4,0,0,0,0,0,0,0,0,3,2,4,0,0,1
1,2,2,8,2,1,0,2,2,1,1,2,2,0,1,2,10,2,2,1
1,0,0,6,2,5,0,0,3,1,1,4,0,0,6,2,5,0,0,1
1,0,0,0,0,0,0,0,1,0,0,1,0,0,0,0,0,0,0,1
1,0,0,0,0,0,2,0,1,0,0,1,0,2,0,0,0,0,0,1
1,0,2,0,2,0,0,0,6,9,9,5,0,0,0,2,0,2,0,1
1,0,0,0,0,2,0,0,0,0,0,0,0,0,2,0,0,0,0,1
1,2,0,2,0,0,2,2,2,2,2,2,2,2,0,0,2,0,2,1
1,0,0,0,0,0,0,0,0,0,0,0,0,0,0,0,0,0,0,1
1,0,0,2,0,0,0,0,2,2,2,2,0,0,0,0,2,0,0,1
6,2,2,2,2,2,2,2,2,2,2,2,2,2,2,2,2,2,2,5
