4,3,3,3,3,3,5
2,1,1,1,1,1,2
2,1,4,3,5,1,2
2,1,2,1,2,1,2
2,1,7,3,6,1,2
2,1,1,1,1,1,2
7,3,3,3,3,3,6