3,2,2,2,7,7,7,7,7,7,7,7,7,7,7,7,2,2,2,4
1,0,0,0,0,1,0,6,5,9,9,6,5,0,1,0,0,0,0,1
1,0,5,6,0,0,0,0,0,2,4,0,0,0,0,0,5,6,0,1
1,0,5,6,0,10,2,8,0,0,1,0,10,2,8,0,5,6,0,1
1,0,0,6,0,0,0,0,0,0,0,0,0,0,0,0,5,0,0,1
10,4,0,0,0,2,8,0,1,1,0,1,0,10,2,0,0,0,3,8
10,2,1,0,1,0,0,0,1,0,0,1,0,0,0,1,0,1,2,8
10,2,2,1,0,0,2,2,8,0,1,10,2,2,0,0,1,2,2,8
10,2,1,0,1,0,0,0,1,0,0,1,0,0,0,1,0,1,2,8
10,5,0,0,0,2,8,0,1,1,0,1,0,10,2,0,0,0,6,8
1,0,0,6,0,0,0,0,0,0,0,0,0,0,0,0,5,0,0,1
1,0,5,6,0,10,2,8,0,1,0,0,10,2,8,0,5,6,0,1
1,0,5,6,0,0,0,0,0,6,2,0,0,0,0,0,5,6,0,1
1,0,0,0,0,1,0,3,4,7,7,3,4,0,1,0,0,0,0,1
6,2,2,2,9,9,9,9,9,9,9,9,9,9,9,9,2,2,2,5
