4,3,3,3,3,3,3,8,3,3,3,3,3,8,3,3,8,3,8,5
2,1,1,1,1,1,1,2,1,1,1,1,1,2,1,1,2,1,7,9
2,1,4,1,3,5,1,2,1,4,3,5,1,7,5,1,1,1,1,2
2,1,2,1,1,2,1,1,1,1,1,2,1,1,2,1,4,1,1,2
2,1,11,5,1,1,1,2,1,2,1,2,1,4,6,1,2,1,3,9
2,1,7,10,5,1,4,10,3,6,1,7,1,2,1,1,1,1,1,2
2,1,1,1,1,1,7,1,1,1,1,1,1,2,1,3,10,5,1,2
2,1,1,4,9,1,1,1,1,4,3,5,1,1,1,1,1,2,1,2
11,3,1,6,11,5,1,5,1,1,1,2,1,1,4,3,1,6,1,2
2,1,1,1,11,9,1,2,1,1,3,6,1,4,9,1,1,1,1,2
2,1,2,1,1,1,1,7,5,1,1,1,1,1,2,1,11,3,1,2
2,1,11,5,1,2,1,1,2,1,2,1,4,1,1,1,2,1,1,2
2,1,7,6,1,7,3,1,1,1,2,1,2,1,2,1,10,1,3,9
2,1,1,1,1,1,1,1,4,8,9,1,1,1,2,1,1,1,1,2
7,3,3,3,3,3,3,3,10,10,10,3,3,3,10,3,3,3,3,6